1111111111
1P000C01C1
1001000101
1C010E0001
1111111111
