111111111111111111
1000001C0000000C01
1P0000100000000111
100000000111E00001
1110C0000001000001
1C00000010C10000C1
111111111111111111
