1111111111111
1C000010000P1
10C1000001111
10010E01000C1
1111111111111
