11111111111
10E01000001
10001P11C01
1C10001C001
11111111111
