1111111111111111111111111
1C0010000C00001C0001000C1
1000100000000011000100001
1110000000000010000111001
10E0001111110000000000001
1000001C00000000100001111
1011111000000001111000001
10100C0000000001C00000001
10P0000000000001000000C01
1111111111111111111111111
