1111111111
100C000X01
11000P0001
10000000E1
1111111111
