111111111111
11C00000P001
100011000E01
1000P0111001
111111111111
