111111111111
1000C0000001
1E00110P0011
1000E0011001
111111111111
