111111111111
10001000C001
100C00110001
1P0001110E11
111111111111