111111111111
1000P0000101
100001110001
100010001E01
111111111111