111111111111
100C000C0011
11101C001001
10C000P00001
111111111111
