1111111111
1C00011C01
1001100011
100E001101
1111111111
